11
    #####
    #@  #
    #$  #
  ###  $##
  #    $ #
### # ## #   ######
#   # ## #####  ..#
# $             ..#
##### ### # ##  ..#
    #     #########
    #######
